11111111111111111111
10001000010000100001
10011000110001100011
10000000000000000001
10001000010000100001
10011000110001100011
10000000000000000001
10001000010000100001
10011000110001100011
10000000000000000001
10001000010000100001
10011000110001100011
10000000000000000001
10001000010000100001
10011000110001100011
10000000000000000001
10001000010000100001
10011000110001100011
10000000000000000001
11111111111111111111